NO                   ./t.txt	
SO 		./t.txt
   WE	./t.txt
EA           			./t.txt
    F               56,43,43
    C 67,23,221

111111111111111111111111
100N00000100000000001111111
100000001 10000001111
1111111111100000000011111111			
10000000000000011111111
1111111111111111111111
