NO                   ./t.txt	
SO 		./t.txt
   WE	./t.txt
EA           			./t.txt
    F               56,43,43
    C 67,23,221

111111
100001
111111
