NO textures/backroom-wall.png
SO textures/backroom-wall.png
WE textures/backroom-wall.png

C 225,255,272
F 0,0,0

EA textures/backroom-wall.png


1111111111111
1000100010001
1000000011101
10E0100000001
1000100010001
1111111110001
        10001
        10001
         101
         101
        10001
11111111000001111
10000000000000101
 1010010000010001
  10001000000001
  11111111111111